xxxxxxxxxx
x-xx-x---x
x----x-xxx
xx-x-x-xxx
xx---x---x
x--x-xxx-x
xx-xxxx--x
xx----x-xx
xxxxx---xx
xxxxxxxxxx
